WWWWWWWXWWWWWWWWWWWW
WXXXXXXXXXXXXXXXXXXW
WWWWXXWXWWWWXWWWWWWW
WXXXXXXXXXXXXXXXXXWW
WWWWWWWXWWWWWXWWWWWW
WXXXXXXXXXXXXXXWXXXW
WWWWWWWXWWWWWWWWWWWW
WXXXXXXXXXXXXXXXXXXW
WWWWWXWXWXWWWWXWWXWW
WXXXXXXXXXXXXXXXXXXW
WWWXWWXXWWXWWWXWXWWW
WXXWWXXWXXXXXWXWXXXW
WWWWWWWXWWWWXWWWWWWW
WXXWXXXXXXXXXXXXXXXW
WWWWWXWXWWWWWWWWWWWW
WXXXXXXXXXXWXXXXXXXW
WWXWWWXXWWXWWWWWXWXW
WXWXXXXXXXXXWXXXXXWW
WXXWWWWXWWWWWWWWWWWW
WWWWWWWWWWWWWWWWWWWW
